20,20
13,14,12,13
0,0,1,1,0,0,0,1,0,0,0,0,1,0,0,0,1,0,0,1
1,0,0,0,0,0,1,0,0,0,1,0,1,0,0,0,0,0,1,1
1,0,1,0,1,1,0,0,0,1,0,0,0,0,0,0,0,1,1,0
0,0,1,1,1,0,1,1,0,0,0,1,1,1,0,0,0,0,0,0
0,0,0,0,0,1,1,0,0,0,0,0,1,1,1,0,0,1,1,0
0,1,0,0,0,1,0,1,0,0,0,0,0,0,0,0,0,1,0,0
0,0,0,1,0,0,0,0,0,0,1,0,0,0,0,0,0,0,1,0
0,0,1,0,1,1,0,1,1,0,1,0,0,0,1,1,0,1,1,0
1,0,0,0,0,1,0,1,0,0,1,0,1,1,0,1,0,0,0,0
1,0,0,1,0,0,1,0,0,1,1,0,0,1,1,1,0,1,1,0
0,1,1,0,1,0,0,0,0,0,1,1,0,1,0,0,0,0,1,1
0,0,0,0,0,1,0,0,0,0,0,0,0,0,0,0,1,1,1,0
1,0,0,0,1,0,1,0,0,0,0,0,0,0,1,1,0,1,0,1
1,0,0,0,0,1,0,0,1,1,0,1,0,0,0,0,0,0,0,0
1,1,0,0,0,0,0,1,0,0,0,1,0,0,0,0,0,0,1,0
1,1,1,0,1,0,1,1,0,0,0,0,0,0,0,0,0,1,0,0
0,0,1,0,0,0,0,1,0,0,0,0,0,0,0,1,0,0,1,0
0,0,0,0,0,0,1,0,1,0,1,1,1,0,0,0,0,0,0,1
0,0,0,0,0,0,0,0,0,0,0,0,0,0,1,0,0,1,1,1
0,0,0,0,0,0,0,0,1,1,0,0,0,0,0,1,0,0,0,0
