20,20
0,9,6,16
1,0,0,1,0,0,1,0,0,0,0,0,0,0,1,0,1,0,0,0
1,0,1,0,0,0,0,1,0,1,0,0,0,0,1,0,0,0,0,0
0,0,0,1,1,0,0,0,0,0,1,1,1,0,0,0,0,0,1,1
0,0,0,1,0,0,0,0,0,0,0,1,0,1,0,0,0,1,0,0
0,1,0,1,0,0,0,0,0,0,0,0,1,0,0,0,1,0,0,0
0,0,0,1,0,1,0,0,1,1,0,0,0,1,1,1,0,0,1,0
1,0,0,0,0,0,0,0,1,0,1,0,0,1,0,1,0,0,0,1
0,1,0,0,1,0,1,0,0,0,0,0,0,1,1,0,0,0,0,0
0,0,1,0,0,0,1,1,0,1,0,0,1,1,0,0,0,0,1,0
0,0,0,0,0,0,1,0,0,1,1,1,1,1,1,0,0,1,0,0
1,1,0,0,0,0,0,0,1,0,0,0,0,1,1,0,0,0,1,1
0,0,0,1,0,1,1,1,0,0,0,1,0,1,1,0,0,1,1,1
0,1,0,1,0,0,0,0,0,0,0,0,1,0,0,1,0,1,0,1
0,0,0,0,0,0,1,0,0,1,0,0,0,0,0,0,1,0,0,0
1,1,1,0,0,0,1,0,0,0,0,0,1,0,0,0,0,0,0,0
0,0,0,0,1,0,1,0,0,1,1,1,0,0,1,0,0,0,0,0
0,1,0,0,0,0,1,0,1,0,0,0,1,0,0,0,0,0,0,0
0,0,0,0,0,0,1,0,0,0,1,0,0,1,1,1,0,0,0,0
0,0,0,0,0,0,0,1,1,0,0,0,1,0,0,0,0,1,0,0
0,0,0,1,1,1,0,0,0,0,0,1,0,1,0,0,0,0,0,1
