20,20
15,8,18,1
0,0,0,0,0,0,0,1,0,0,1,1,1,0,0,1,0,0,0,0
1,0,0,0,0,0,0,0,0,1,0,1,1,0,0,1,0,0,0,0
0,1,0,0,0,1,0,0,1,0,0,0,1,0,0,0,1,0,0,1
1,1,0,0,1,1,1,1,0,0,0,1,0,1,0,1,0,1,0,1
1,0,0,1,0,1,0,0,0,1,1,0,1,0,0,0,1,0,1,0
0,1,0,1,0,0,0,0,1,0,0,1,1,1,0,1,0,0,0,0
0,0,0,1,0,0,1,1,1,1,1,0,0,1,0,0,1,0,0,1
0,0,0,0,0,0,0,0,0,1,0,1,0,0,0,0,0,0,0,0
0,0,1,0,0,0,0,0,0,0,0,1,0,1,1,0,0,0,0,0
0,0,0,0,1,0,0,0,1,1,0,0,0,1,0,0,0,1,1,0
0,0,0,0,0,0,0,0,0,1,0,0,0,1,0,1,0,0,1,0
1,0,0,0,0,0,0,0,0,0,0,1,0,0,1,1,1,1,0,1
1,0,0,1,0,1,0,0,0,1,0,0,0,1,0,0,0,0,1,0
1,0,0,0,0,0,0,1,1,0,1,0,1,0,1,1,0,0,0,0
1,1,0,0,0,0,0,1,0,0,0,0,1,0,0,0,0,0,0,0
0,0,0,0,0,1,1,0,0,0,0,0,0,1,0,0,0,0,0,1
0,0,0,0,0,0,0,0,0,0,1,1,0,0,0,0,0,1,0,0
1,0,0,1,1,1,1,0,1,0,0,1,0,0,0,0,0,1,0,0
0,0,1,0,0,0,0,0,1,1,1,0,1,0,0,0,0,0,1,1
0,0,0,0,0,0,0,0,0,1,1,0,1,1,0,0,0,1,1,0
