20,20
9,11,13,11
0,0,1,0,0,1,1,0,0,0,1,0,0,0,0,1,1,0,0,0
0,0,0,0,0,0,1,1,0,0,1,0,1,0,0,1,0,1,1,1
1,0,0,0,0,0,0,0,0,0,1,0,1,0,0,0,0,0,0,0
0,0,1,1,1,0,0,1,0,1,0,0,0,0,0,1,0,0,1,0
1,0,1,0,0,1,1,0,1,1,0,0,0,1,0,1,0,1,0,1
0,0,1,0,0,0,0,0,1,1,0,1,1,0,1,1,1,0,1,0
1,0,0,1,0,0,0,0,1,1,0,1,0,0,1,0,1,0,0,0
1,0,1,1,0,0,0,0,0,0,0,1,0,0,1,0,0,0,1,1
1,0,0,1,0,0,0,0,0,0,1,0,0,0,0,1,0,0,0,1
0,0,1,0,0,0,0,0,1,0,0,0,1,1,0,0,0,1,1,0
1,1,0,0,0,0,1,0,0,0,0,1,1,0,0,0,1,0,0,0
0,1,1,0,0,0,0,1,0,0,1,0,0,0,0,1,1,0,1,0
0,1,0,0,0,0,0,0,0,0,0,1,0,1,0,0,1,1,0,0
0,1,0,0,1,0,0,0,1,0,1,0,0,0,1,0,0,0,1,0
0,0,1,0,1,1,1,1,1,0,0,0,0,1,1,0,1,0,0,1
0,0,0,0,0,0,0,0,0,0,0,0,0,0,0,0,0,1,0,0
1,0,1,0,1,1,0,0,1,0,1,1,0,0,1,1,0,0,1,0
0,0,0,0,1,1,0,0,1,0,0,0,0,1,0,0,0,1,1,0
1,0,1,0,0,0,1,1,1,0,0,0,1,0,1,0,0,0,0,1
0,1,1,1,0,0,1,0,1,0,0,0,0,1,1,0,0,0,0,1
